NN............................NN
N..............................N
.................H.............N
...........................@...N
...............................N
...............................N
...............................N
...............................N
...........@...............NNNNN
............................iiAN
.....YZZZZa................NNNNN
....HeffffgH...................N
....vvvvvvvv...................N
....HeffffgH...............@...N
.....kllllm....................N
...............................N
...............................N
...............................N
.................MNO...........N
.................STU...........N
...............................N
.....@.........................N
N..............................N
NNNNNNNNNNNNNNN..NNNNNNNNNNNNNNN
