NNNNNNNNNNNNNNN..NNNNNNNNNNNNNNN
N..............................N
N..............................N
N..............................N
N..............................N
N..............................N
N..............................N
N..............................N
N..............................N
N..............................N
N..............................N
................................
................................
N..............................N
N..............................N
N..............................N
N..............................N
N..............................N
N..............................N
N..............................N
N..............................N
N..............................N
N..............................N
NNNNNNNNNNNNNNNNNNNNNNNNNNNNNNNN